{
    "1": 
    [
        [0,0,0,0,0,0,0,0,0,0,0,0,0,0,0,0],
        [0,0,0,0,1,1,1,1,1,0,0,0,0,0,0,0],
        [0,0,0,0,2,2,2,2,2,1,1,0,0,0,0,0],
        [0,0,0,0,2,2,2,2,7,2,2,2,2,0,0,0],
        [0,0,0,0,2,2,2,6,8,7,2,2,2,0,0,0],
        [0,0,0,0,5,0,2,2,7,2,2,2,2,0,0,0],
        [0,0,0,0,3,0,2,2,2,2,2,2,2,0,0,0],
        [0,0,0,0,0,0,2,2,2,2,2,2,2,0,0,0],
        [0,0,0,0,0,0,0,0,0,0,0,0,0,0,0,0],
        [0]
    ],
    "2":
    [
        [0,0,0,0,0,0,0,0,0,0,0,0,0,0,0,0], 
        [0,0,0,0,1,1,1,1,1,1,1,1,0,0,0,0], 
        [0,0,0,1,2,2,2,2,2,2,2,2,1,0,0,0], 
        [0,0,0,2,2,2,2,2,2,2,2,2,7,0,0,0], 
        [0,0,0,7,2,2,2,8,2,2,2,2,2,0,0,0], 
        [0,0,0,0,0,0,0,2,0,0,0,0,0,0,0,0], 
        [0,0,0,0,0,0,0,5,0,0,0,0,0,0,0,0], 
        [0,0,0,0,0,0,0,3,0,0,0,0,0,0,0,0], 
        [0,0,0,0,0,0,0,0,0,0,0,0,0,0,0,0],
        [0]
    ],
    "3": 
    [
        [0,0,0,0,0,0,0,0,0,0,0,0,0,0,0,0],
        [0,0,1,1,1,1,1,1,1,1,1,1,1,0,0,0],
        [0,0,2,2,2,2,2,2,2,2,2,2,7,0,0,0],
        [0,0,2,2,1,1,1,1,1,1,1,1,2,0,0,0],
        [0,0,2,2,2,2,2,2,8,2,2,2,2,0,0,0],
        [0,0,2,2,1,1,1,1,1,1,1,1,2,0,0,0],
        [0,0,2,2,2,2,2,2,2,2,2,2,2,1,0,0],
        [0,0,6,2,2,2,2,2,2,2,2,2,5,3,0,0],
        [0,0,0,0,0,0,0,0,0,0,0,0,0,0,0,0],
        [1]
    ],
    "4": 
    [
        [0,0,0,0,0,0,0,7,8,0,0,0,0,0,0,0],
        [0,0,0,0,0,0,0,2,2,0,0,0,0,0,0,0],
        [0,0,1,1,1,1,1,2,2,1,1,1,1,1,0,0],
        [0,0,2,2,2,2,2,2,2,2,2,2,2,2,0,0],
        [0,0,2,2,2,1,1,1,1,1,1,2,2,2,0,0],
        [0,0,1,7,2,2,2,2,2,2,2,2,6,1,0,0],
        [0,0,0,2,2,2,2,2,2,2,2,2,2,0,0,0],
        [0,0,0,0,0,0,0,4,4,0,0,0,0,0,0,0],
        [0,0,0,0,0,0,0,3,2,0,0,0,0,0,0,0],
        [2]
    ],
    "5":
    [
        [0,0,0,0,0,0,0,0,0,0,0,0,0,0,0,0], 
        [1,1,1,1,1,1,1,1,1,1,1,1,1,1,1,1], 
        [7,2,2,2,2,2,2,2,8,2,2,2,2,2,2,7], 
        [1,1,1,1,1,1,2,2,2,2,1,1,1,1,1,1], 
        [2,2,2,2,2,1,1,2,2,1,0,0,0,0,0,0], 
        [2,2,2,2,2,1,2,2,2,0,0,0,0,0,0,0], 
        [2,2,0,2,2,2,2,2,2,0,0,0,0,0,0,0], 
        [4,0,0,0,2,2,2,0,0,0,0,0,0,0,0,0], 
        [3,0,0,0,0,0,0,0,0,0,0,0,0,0,0,0],
        [2]
    ],
    "6":
    [
        [2,2,2,0,2,2,2,0,7,2,2,0,2,2,2,0], 
        [2,0,2,0,2,0,2,0,2,2,2,0,2,2,2,0], 
        [2,0,2,0,2,0,2,0,2,0,2,0,2,2,2,0], 
        [2,0,2,0,2,0,2,0,2,0,2,0,2,0,2,0], 
        [2,0,2,0,2,0,2,0,2,0,2,0,2,0,2,0], 
        [2,0,2,0,2,0,2,0,2,0,2,1,2,0,2,0], 
        [2,0,2,0,2,0,2,0,2,0,2,2,2,0,5,0], 
        [2,0,2,1,2,0,2,1,2,0,2,2,2,0,2,0], 
        [8,0,2,2,2,0,2,2,2,0,7,2,2,0,3,0],
        [1]
    ],
    "7":
    [
        [0,0,0,0,1,1,2,0,0,0,0,0,0,0,0,0], 
        [0,0,0,0,7,8,2,2,0,0,0,0,0,0,0,0], 
        [0,0,0,0,6,2,2,2,0,0,0,0,0,0,0,0], 
        [0,0,0,0,0,2,2,2,0,0,0,0,0,0,0,0], 
        [0,0,0,0,0,0,2,1,0,0,0,0,0,0,0,0], 
        [0,1,1,1,1,1,2,2,0,0,0,0,0,0,0,0], 
        [0,3,4,2,2,2,2,2,0,0,0,0,0,0,0,0], 
        [0,0,0,0,2,2,2,2,0,0,0,0,0,0,0,0], 
        [0,0,0,0,0,0,2,0,0,0,0,0,0,0,0,0],
        [0]
    ],
    "8":
    [
        [0,0,0,0,0,0,0,0,0,1,1,1,1,1,1,0], 
        [0,0,0,0,0,0,0,0,0,2,2,2,2,5,2,0], 
        [0,0,0,0,0,0,0,0,0,2,2,2,2,5,3,0], 
        [0,0,0,0,0,0,0,0,0,2,0,2,7,0,0,0], 
        [0,0,0,0,0,0,0,0,1,2,0,0,0,0,0,0], 
        [0,1,1,1,1,1,1,1,7,2,0,0,0,0,0,0], 
        [0,8,2,2,2,2,2,2,2,2,0,0,0,0,0,0], 
        [0,0,0,0,0,0,0,0,0,0,0,0,0,0,0,0], 
        [0,0,0,0,0,0,0,0,0,0,0,0,0,0,0,0],
        [0]
    ],
    "9":
    [
        [0,0,0,0,0,1,2,2,2,2,2,0,1,0,0,0], 
        [0,0,0,0,1,2,2,2,1,2,2,1,8,0,0,0], 
        [0,0,0,0,6,2,2,0,2,2,0,2,2,0,0,0], 
        [0,0,0,0,2,2,2,0,2,2,0,2,1,1,0,0], 
        [0,0,0,0,0,2,0,0,2,1,1,2,2,2,0,0], 
        [0,0,0,0,0,2,0,0,2,2,6,0,0,2,0,0], 
        [0,1,1,1,1,2,2,0,2,2,2,1,1,2,0,0], 
        [0,3,4,2,2,2,2,2,0,2,2,2,2,2,0,0], 
        [0,0,0,0,0,2,2,2,0,0,0,0,0,0,0,0],
        [1]
    ],
    "10":
    [
        [0,2,2,2,7,2,2,2,2,2,0,0,0,0,0,0], 
        [0,2,2,2,2,0,0,2,2,2,0,0,0,0,0,0], 
        [1,2,0,0,0,0,0,2,2,2,0,0,0,0,0,0], 
        [2,2,1,1,1,1,0,2,0,0,0,0,0,0,0,0], 
        [7,2,2,2,2,2,0,2,0,0,0,0,0,0,0,0], 
        [0,1,1,1,0,2,0,2,0,0,0,0,0,0,0,0], 
        [0,2,2,2,0,2,0,2,0,0,0,0,0,0,0,0], 
        [0,8,0,2,1,2,0,4,0,0,0,0,0,0,0,0], 
        [0,0,0,2,2,2,0,3,0,0,0,0,0,0,0,0],
        [2]
    ]

}