{
    "custom":
    [
        [0,0,0,0,0,0,0,0,0,0,0,0,0,0,0,0], 
        [0,0,0,0,0,0,0,0,0,0,0,0,0,0,0,0], 
        [0,0,0,0,0,0,0,0,0,0,0,0,0,0,0,0], 
        [0,0,0,1,1,1,1,1,1,1,1,0,0,0,0,0], 
        [0,0,0,3,4,2,6,0,8,2,6,0,0,0,0,0], 
        [0,0,0,0,0,0,0,0,0,0,0,0,0,0,0,0], 
        [0,0,0,0,0,0,0,0,0,0,0,0,0,0,0,0], 
        [0,0,0,0,0,0,0,0,0,0,0,0,0,0,0,0], 
        [0,0,0,0,0,0,0,0,0,0,0,0,0,0,0,0],
        [0]
    ]
}